{
    "layer": "hillzip2010",
    "property": "GEOID10",
    "values": [
        "33503",
        "33510",
        "33511",
        "33527",
        "33534",
        "33540",
        "33547",
        "33548",
        "33549",
        "33556",
        "33558",
        "33559",
        "33563",
        "33565",
        "33566",
        "33567",
        "33569",
        "33570",
        "33572",
        "33573",
        "33578",
        "33579",
        "33584",
        "33592",
        "33594",
        "33596",
        "33598",
        "33602",
        "33603",
        "33604",
        "33605",
        "33606",
        "33607",
        "33609",
        "33610",
        "33611",
        "33612",
        "33613",
        "33614",
        "33615",
        "33616",
        "33617",
        "33618",
        "33619",
        "33620",
        "33621",
        "33624",
        "33625",
        "33626",
        "33629",
        "33634",
        "33635",
        "33637",
        "33647",
        "33810",
        "33811",
        "33815",
        "33834",
        "33860",
        "34219",
        "34221"
    ]
}