{
    "layer": "SAR_ZIP_2010",
    "property": "GEOID10",
    "values": [
        "34266",
        "34288",
        "34228",
        "34229",
        "34231",
        "34232",
        "34233",
        "34234",
        "34235",
        "34236",
        "34237",
        "34238",
        "34239",
        "34240",
        "34241",
        "34242",
        "34243",
        "34275",
        "33981",
        "34223",
        "34224",
        "34286",
        "34287",
        "34293",
        "34285",
        "34289",
        "34291",
        "34292"
    ]
}