{
    "layer": "MAN_ZIP_2010",
    "property": "GEOID10",
    "values": [
        "34251",
        "33598",
        "33834",
        "34201",
        "34202",
        "34203",
        "34205",
        "34207",
        "34208",
        "34209",
        "34210",
        "34211",
        "34212",
        "34215",
        "34216",
        "34217",
        "34219",
        "34221",
        "34222",
        "34228",
        "34243"
    ]
}