{
    "layer": "PIN_ZIP_2010",
    "property": "GEOID10",
    "values": [
        "34688",
        "34689",
        "33715",
        "33701",
        "33702",
        "33703",
        "33704",
        "33705",
        "33706",
        "33707",
        "33708",
        "33709",
        "33710",
        "33711",
        "33712",
        "33713",
        "33714",
        "33716",
        "33744",
        "33755",
        "33756",
        "33759",
        "33760",
        "33761",
        "33762",
        "33763",
        "33764",
        "33765",
        "33767",
        "33770",
        "33771",
        "33772",
        "33773",
        "33774",
        "33776",
        "33777",
        "33778",
        "33781",
        "33782",
        "33785",
        "33786",
        "34677",
        "34681",
        "34683",
        "34684",
        "34685",
        "34695",
        "34698"
    ]
}